100000000000000000000000111111111110000000000000000000000000000000000000000000000000000000000000000000000000000011111111111144444444444444444444444444411111111111100000000000011111111111100000000000000000000000000000000000000000000000011111111111100000000000000000000000000000000000000000001111111111111111111111111111111111000000000000000000000000000000000000000000111111111111000000000000000000000000000111111111111000000000000111111111111
100000000000000000000000111111111110000000000000000000000000000000000000000000000000000000000000000000000000000011111111111100000000000000000000000000011111111111100000000000011111111111100000000000000000000000000000000000000000000000011111111111100000000000000000000000000000000000000000005444444444444444444444444444444446000000000000000000000000000000000000000000111111111111000000000000000000000000000111111111111000000000000111111111111
100000000000000000000000111111111110000000000000000000000000000000000000000222220000000000000000000000000000000011111111111000000000000000000000000000011111111111000000000000111111111111000000000000000000000000000000000000000000000000111111111111000000000008222222222220000000000000000000000000000000000000000000000000000000000000000000092222222222222000000000000000111111111110000000000000000000000000000111111111110000000000001111111111111
100000000000000000000000111111111110000000000000000000000000000000000000000111119000000000000000000000000000000011111111111100000000022222222222200000011111111111100000000000011111111111100000000000005444444444600000000000000000000000011111111111100000000000111111111111000000000000000000000000000000000000000000000000000000000000000000001111111111111800000000000000111111111111000000000222222222222000000111111111111000000000000111111111111
100000000000000000000000111111111600000000000000000000000000000000000000000111100000000000000000000000000000000011111111111100000822211111111111100000011111111111100000000000011111111111100000000000000000000000000000000000000000000000054444444444600000008222111111111111000000000000022222222222222222222222222222222222222222900000000000000000000000000000000000000000111111111111000008222111111111111000000111111111111000000000000111111111111
100000000000000000000000111111116000000000000000000000000000000000000000000111000000000000000000000000000000000011111111111100000000011111111111100000011111111111100000000000010111331111100000000000000000000000000082222229000000000000000000000000000000000000111111111111222229000000000000001111111111111111111111111111111111000000000000000000000000000000000000000000111111111111000000000111111111111000000111111111111290000000000111111111111
100000000000000000000000111111160000000000000000000000000000000000000000000111000000000000000000000000000000000011111111111100000000011111111111100000011111111111100000000000000500440044600000000000000000000000000000000000000000000000000000000000000000000000111111111111000000000000000000001111111111111111111111111111111111000000000000000000000000000000000000008222111111111111000000000111111111111000000111111111111000000000000111111111111
100000000000000000000000144460000000000000000000000022220000000222222229000111222900000000000000000000000000000000111111111122290000011111111111100000011111111111000000000000000000000000000000000000000000000000000000000000000000000000000000000222900000000000111111111111000000000000822222221111111111111111111111111111111111000000000000000000000000000000000000000000111111111111222900000111111111111000000111111111111000000000822111111111111
100000000000000000000000100000000000000000000000000011110000000111111110000111000000000000002222229000000000000000111111111100000000011111111111100000011111111110000000000000000000000000000000000000000000000000000000000000000000000000000000002111000000000008111111111110000000000000000000011111111111111111111111111111111110000000000000000000000000000000000000000000111111111110000000008111111111110000000511111111110000000000000000000000000
100000000000000000000000100000000000000000000000000011100000000111110000000111000000002222221111110000000000000000011111111100000000011111111111100000011111111100000000000000022222290082900000000000000000000000000000000000000000000000000000221111100000000000111111111111222229000000000000001111111111111111111111111111111111000000000082222222222000000000000000000000011111111111900000000011111111111000000011111111100000000000000000000000000
100000000000000000000000400000000000000000000000000011100002222111110000000000000000001111111111000000000000000000044400044400000822211111111111100000054444444600000000000000811110000001000000000000000000000000000000000000000000000000000000111111100000000000444444444444000000000000000000001111111111111111111111111111111111000000000000011111111900000000000000000000544444444446000008222111111111111000000544444446000000000000000000000000000
100000000000000000000000000000000000000002222200000011100001111000000000000000000000000000000000000000000000000000000000000000000000011111111111100000000000000000000000000000000000000000000000000000000000000000000000000000000000000002222222111111100000000000000000000000000000000008222222221111111111111111111111111111111111000000000000011111111000000000000000000000000000000000000000000111111111111000000000000000000000000000000000000000000
100000000000000000000000000000000000000001111100000011100001111100000011111111100000000000000000000000000000000000000000000000000000011111111111100000000000000000000000000000000000000000000000000000000000000000000000000000000000000001111111111111100000000000000000000000000000000000000000001111111111111111111111111111111111000000000000011111111200000000000000000000000000000000000000000111111111111000000000000000000000000000000000000000000
222222222222222222222222222222222222222221111100000011111111111111100000111111122222222222222222222222200000000002222222222222222222211111111111122222222222222222200000000022222222222222222222200000000022222222200000002222222222222211111111111111122222222222222222222222222222000000000000001111111111111111111111111111111111222222222222222222222222222222222222222222222222222222222222222111111111111222222222222222222000000002222222222222222
111111111111111111111111111111111111111111111100000011111111110000000111111111111111111111111111111111100000000001111111111111111111111111111111111111111111111111100000000011111111111111111111100000000811111111100000821111111111111111111111111111111111111111111111111111111111000000000000000000111111111111111111111111111111111111111111111111111111111111111111111111111111111111111111111111111111111111111111111111111000000001111111111111111
111111111111111111111111111111111111111111111100000011111111110000000111111111111111111111111111111111100000000001111111111111111111111111111111111111111111111111100000000011111111111111111111100000000000000000000000001111111111111111111111111111111111111111111111111111111111000000000000000000111111111111111111111111111111111111111111111111111111111111111111111111111111111111111111111111111111111111111111111111111000000001111111111111111
111111111111111111111111111111111111111111111100000011111111111111111111111111111111111111111111111111100000000001111111111111111111111111111111111111111111111111100000000011111111111111111111100000000000000000000000001111111111111111111111111111111111111111111111111111111111000000000000000000111111111111111111111111111111111111111111111111111111111111111111111111111111111111111111111111111111111111111111111111111000000001111111111111111
111111111111111111111111111111111111111111111100000011111111111111111111111111111111111111111111111111111111111111111111111111111111111111111111111111111111111111100000000011111111111111111111100000022222222222222000001111111111111111111111111111111111111111111111111111111111000000000000000000111111111111111111111111111111111111111111111111111111111111111111111111111111111111111111111111111111111111111111111111111000000001111111111111111
111111111111111111111111111111111111111111111100000011111111111111111111111111111111111111111111111111111111111111111111111111111111111111111111111111111111111111100000000011111111111111111111100000011111111111111000001111111111111111111111111111111111111111111111111111111111000000000000000000111111111111111111111111111111111111111111111111111111111111111111111111111111111111111111111111111111111111111111111111111000000001111111111111111
111111111111111111111111111111111111111111111100000011111111111111111111111111111111111111111111111111111111111111111111111111111111111111111111111111111111111111100000000011111111111111111111100000011111111111111000001111111111111111111111111111111111111111111111111111111111000000000000000000111111111111111111111111111111111111111111111111111111111111111111111111111111111111111111111111111111111111111111111111111000000001111111111111111


